<level name="The underground lab..." music="Lightless Dawn.mp3">
	<map>
		@ . . . . . . . . . . . . . . . . . . . . . . . . . . . . . . . . . . . . . . . . . . . .
		o T . . . . . . . . . . . . . . . . . . . . . . . . . . . . . . . . . . . . . . . . . . .
		o o o o o o o o o o o o o o o o o o o o o o o o o o o o o o o o o o o o o o o o o o o o *
		. . . . . . . o o o o o o o o o . . . . . . . . . . . . . . . . . . . . . . . . . . . . .
		. . . . . . . o o o o o o o o o . . . . . . . . . . . . . . . . . . . . . . . . . . o o o
		. . . . . . . o o o o g o o o o . . . . . . . . . . . . . . . . . . . . . . . . . . o * o
		. . . . . . . o o o o o o o o o . o o o o o . . . . . . . o o o o o . . . . . . . . o o o
		. . . . . . . o o o o o o o o o . . . . . . . . . . . . . . . . . . . . . . . . . . . . .
		. . . . . . . . . . . . . . . . . . . . . . . o o o o o . . . . . . . o o o o o . . . . .
	</map>
	<dialog trigger="0,8" blocksGameplay="true">
		<text wait="2"></text>
		<text wait="3">\tAn abandoned lab!\n</text>
		<text wait="3">What could be in here?</text>
	</dialog>
	<dialog trigger="17,2" blocksGameplay="false">
		<text wait="0.5">Amazing!\n</text>
		<text wait="3">\tYou can teleport!</text>
	</dialog>
	<dialog trigger="23,0" blocksGameplay="true">
		<text wait="0.1">Press R to start again\n</text>
		<text wait="3">\t... if you need to.</text>
	</dialog>
	<teleport from="15,2" to="17,2" />
	<teleport from="21,2" to="23,0" />
	<teleport from="27,0" to="29,2" />
	<teleport from="33,2" to="35,0" />
	<teleport from="39,0" to="42,2" />
	<shadow-mask>
		. . . . . . . . . . . . . . . . . . . . . . . . . . . . . . . . . . . . . . . . . . . . .
		. . . . . . . . . . . . . . . . . . . . . . . . . . . . . . . . . . . . . . . . . . . . .
		. . . . . . . . . . . . . . . . . . x x x . . . . . . . . . . . . . . . . . . . . . . . .
		. . . . . . . . . . . . . . . . . . . . . . . . . . . . . . . . . . . . . . . . . . . . .
		. . . . . . . . . . . . . . . . . . . . . . . . . . . . . . . . . . . . . . . . . . . . .
		. . . . . . . . . . . . . . . . . . . . . . . . . . . . . . . . . . . . . . . . . . . . .
		. . . . . . . . . . . . . . . . . . . o . . . . . . . . . . . . . . . . . . . . . . . . .
		. . . . . . . . . . . . . . . . . . . . . . . . . . . . . . . . . . . . . . . . . . . . .
		. . . . . . . . . . . . . . . . . . . . . . . . . . . . . . . . . . . . . . . . . . . . .
	</shadow-mask>
	<shadow-mask>
		. . . . . . . . . . . . . . . . . . . . . . . . . . . . . . . . . . . . . . . . . . . . .
		. . . . . . . . . . . . . . . . . . . . . . . . . . . . . . . . . . . . . . . . . . . . .
		. . . . . . . . . . . . . . . . . . . . . . . . x x x . . . . . . . . . . . . . . . . . .
		. . . . . . . . . . . . . . . . . . . . . . . . . . . . . . . . . . . . . . . . . . . . .
		. . . . . . . . . . . . . . . . . . . . . . . . . . . . . . . . . . . . . . . . . . . . .
		. . . . . . . . . . . . . . . . . . . . . . . . . . . . . . . . . . . . . . . . . . . . .
		. . . . . . . . . . . . . . . . . . . . . . . . . . . . . . . . . . . . . . . . . . . . .
		. . . . . . . . . . . . . . . . . . . . . . . . . . . . . . . . . . . . . . . . . . . . .
		. . . . . . . . . . . . . . . . . . . . . . . . . o . . . . . . . . . . . . . . . . . . .
	</shadow-mask>
	<shadow-mask>
		. . . . . . . . . . . . . . . . . . . . . . . . . . . . . . . . . . . . . . . . . . . . .
		. . . . . . . . . . . . . . . . . . . . . . . . . . . . . . . . . . . . . . . . . . . . .
		. . . . . . . . . . . . . . . . . . . . . . . . . . . . . . x x x . . . . . . . . . . . .
		. . . . . . . . . . . . . . . . . . . . . . . . . . . . . . . . . . . . . . . . . . . . .
		. . . . . . . . . . . . . . . . . . . . . . . . . . . . . . . . . . . . . . . . . . . . .
		. . . . . . . . . . . . . . . . . . . . . . . . . . . . . . . . . . . . . . . . . . . . .
		. . . . . . . . . . . . . . . . . . . . . . . . . . . . . . . o . . . . . . . . . . . . .
		. . . . . . . . . . . . . . . . . . . . . . . . . . . . . . . . . . . . . . . . . . . . .
		. . . . . . . . . . . . . . . . . . . . . . . . . . . . . . . . . . . . . . . . . . . . .
	</shadow-mask>
	<shadow-mask>
		. . . . . . . . . . . . . . . . . . . . . . . . . . . . . . . . . . . . . . . . . . . . .
		. . . . . . . . . . . . . . . . . . . . . . . . . . . . . . . . . . . . . . . . . . . . .
		. . . . . . . . . . . . . . . . . . . . . . . . . . . . . . . . . . . . x x x . . . . . .
		. . . . . . . . . . . . . . . . . . . . . . . . . . . . . . . . . . . . . . . . . . . . .
		. . . . . . . . . . . . . . . . . . . . . . . . . . . . . . . . . . . . . . . . . . . . .
		. . . . . . . . . . . . . . . . . . . . . . . . . . . . . . . . . . . . . . . . . . . . .
		. . . . . . . . . . . . . . . . . . . . . . . . . . . . . . . . . . . . . . . . . . . . .
		. . . . . . . . . . . . . . . . . . . . . . . . . . . . . . . . . . . . . . . . . . . . .
		. . . . . . . . . . . . . . . . . . . . . . . . . . . . . . . . . . . . . o . . . . . . .
	</shadow-mask>
	<shadow-mask>
		. . . . . . . . . . . . . . . . . . . . . . . . . . . . . . . . . . . . . . . . . . . . .
		. . . . . . . . . . . . . . . . . . . . . . . . . . . . . . . . . . . . . . . . . . . . .
		. . . . . . . . . . . . . . . . . . . . . . . . . . . . . . . . . . . . . . . . . . . o .
		. . . . . . . . . . . . . . . . . . . . . . . . . . . . . . . . . . . . . . . . . . . . .
		. . . . . . . . . . . . . . . . . . . . . . . . . . . . . . . . . . . . . . . . . . x x x
		. . . . . . . . . . . . . . . . . . . . . . . . . . . . . . . . . . . . . . . . . . x x x
		. . . . . . . . . . . . . . . . . . . . . . . . . . . . . . . . . . . . . . . . . . x x x
		. . . . . . . . . . . . . . . . . . . . . . . . . . . . . . . . . . . . . . . . . . . . .
		. . . . . . . . . . . . . . . . . . . . . . . . . . . . . . . . . . . . . . . . . . . . .
	</shadow-mask>
</level>