<level name="So it begins">
	<map>
		. . . . . o o o . . . .
		@ o o o o o . o o b o .
		. . . . . o o o o o o o
		. . . o r o . . w . . l
		. . . o o o . . w . l l
		. . . * o o . . w . l l
		. . . . . . . . * . l l
		. . . . . . . . . . . l
		. . . . . . . . . . . *
	</map>
	<shadow-mask>
		. . . . . . . . . . . .
		. . . . . . . . . . . .
		. . . . x . . . . . o .
		. . . x x . . . . . . .
		. . . x x x . . . . . .
		. . . x x x . . . . . .
		. . . . . . . . . . . .
		. . . . . . . . . . . .
		. . . . . . . . . . . .
	</shadow-mask>
	<shadow-mask>
		. . . . . . . . . . . .
		. . . . . . . . . . . .
		. . . . . . . . . . . .
		. . . . . . . . . . . .
		. . . . . . . . . . . .
		. . . . . o . . . . x x
		. . . . . . . . . . x x
		. . . . . . . . . . . x
		. . . . . . . . . . . x
	</shadow-mask>
	<dialog trigger="0,7" blocksGameplay="true">
		<text wait="2"></text>
		<text wait="2">Oh...</text>
		<text wait="2">Hello!\n</text>
		<text wait="5">My, aren't you cute!</text>
	</dialog>
</level>