<level name="So it begins">
	<map>
		. . . . . o o o . . .
		@ o o o o o . o o b o
		. . . . . o o o o o o
		. . . . . . . . w . .
		. . . . . . . . w . .
		. . . . . . . . w . .
		. . . . . . . . * . .
	</map>
</level>