<level name="Doing science..." music="Bit Quest.mp3">
	<map>
		. . . . . . . . . . . . . . . . . . . l l o * . . . . . . . . . . . . . . . . .
		. . . . . . . . . . . . . . . . . . . l l o o . . . . . . . . . . . . . . . . .
		. . . . . . . . . . . . . . . . . . . l l . . . . . . . . . . . . . . . . . . .
		. . . . . . . . . . . . . . . . . . . l l . . . . . . . . . . . . . . . . . . .
		. . . . . . . . . . . . . . . . . . . l l . . . . . . . . . . . . . . . . . . .
		. . . . . . . . . . . . . . . . . . l l l l . . . . . . . . . . . . . . . . . .
		. . . . . . . . . . . . . . . . . . l . . l . . . . . . . . . . . . . . . . . .
		. . . . . . . . . . . . . . . . . . l . . l . o r . . . . . . . . . . . . . . .
		. . . . . . . . . . . . . . . . . . l l l l . o o o o . . . . . . . . . . . . .
		. . . . . . . . . . . . . . . . . . l . . . . l . . . . . . . . . . . . . . . .
		. . . . . . . . . . . . . . . o o . l . . . . o . . . . . . . . . . w . . . . .
		. . . . . . . . . . . . . . . o o o o o o o o o o o o o o o o o o o o o o o o *
		. . . . . . . . . . . . . . . . o . w . . . . o . . o . . o . . . . l . . . . .
		. . . . . . . o o . o o . o o . o . w . . . . w . . o . . o . . . . . . . . . .
		. . . . . . . o o . o o . o o . o . w w w w . o o . o . . o . . . . . . . . . .
		. . . . . . . . . . . . . . . . o . w . . w . o b o o o o o . . . . . . . . . .
		. . . . . . . o o . o o . o o . o . w . . w . . . . . . . . . . . . . . . . . .
		. . . . . . . o o . o o . o o . o . w w w w . . . . . . . . . . . . . . . . . .
		. . . . . . . T . . . . . . . . o . . w w . . . . . . . . . . . . . . . . . . .
		. . . . . . . o o . o o . o o . o . . w w . . . . . . . . . . . . . . . . . . .
		. . . . . . . o o . o o . o o . o . . w w . . . . . . . . . . . . . . . . . . .
		. . . . . . . . . . . . . . . . o . . w w o o . . . . . . . . . . . . . . . . .
		. @ o o g o o o o o o o o o o o o . . w w o * . . . . . . . . . . . . . . . . .
	</map>
	<teleport from="8,0" to="7,9" />
	
	<teleport from="8,8" to="7,5" />
	<teleport from="8,6" to="11,9" />
	<teleport from="10,8" to="13,2" />
	<teleport from="14,2" to="8,3" />
	<teleport from="13,3" to="7,5" />
	<teleport from="7,2" to="13,6" />
	<teleport from="14,5" to="11,2" />
	<teleport from="13,5" to="11,9" />
	<teleport from="10,3" to="10,5" />
	<teleport from="11,5" to="13,9" />
	<teleport from="10,6" to="13,6" />
	<teleport from="14,8" to="15,12" />
	
	<teleport from="23,12" to="23,14" />
	<teleport from="23,10" to="23,8" />
	
	<teleport from="26,14" to="30,11" />
	<shadow-mask>
		. . . . . . . . . . . . . . . . . . . . . . . . . . . . . . . . . . . . . . . .
		. . . . . . . . . . . . . . . . . . . . . . . . . . . . . . . . . . . . . . . .
		. . . . . . . . . . . . . . . . . . . . . . . . . . . . . . . . . . . . . . . .
		. . . . . . . . . . . . . . . . . . . . . . . . . . . . . . . . . . . . . . . .
		. . . . . . . . . . . . . . . . . . . . . . . . . . . . . . . . . . . . . . . .
		. . . . . . . . . . . . . . . . . . . . . . . . . . . . . . . . . . . . . . . .
		. . . . . . . . . . . . . . . . . . . . . . . . . . . . . . . . . . . . . . . .
		. . . . . . . . . . . . . . . . . . . . . . . . . . . . . . . . . . . . . . . .
		. . . . . . . . . . . . . . . . . . . . . . . . . . . . . . . . . . . . . . . .
		. . . . . . . . . . . . . . . . . . . . . . . . . . . . . . . . . . . . . . . .
		. . . . . . . . . . . . . . . o . . . . . . . . . . . . . . . . . . . . . . . .
		. . . . . . . . . . . . . . . . . . . . . . . . . . . . . . . . . . . . . . . .
		. . . . . . . . . . . . . . . . x . . . . . . . . . . . . . . . . . . . . . . .
		. . . . . . . . . . . . . . . . x . . . . . . . . . . . . . . . . . . . . . . .
		. . . . . . . . . . . . . . . . x . . . . . . . . . . . . . . . . . . . . . . .
		. . . . . . . . . . . . . . . . x . . . . . . . . . . . . . . . . . . . . . . .
		. . . . . . . . . . . . . . . . x . . . . . . . . . . . . . . . . . . . . . . .
		. . . . . . . . . . . . . . . . x . . . . . . . . . . . . . . . . . . . . . . .
		. . . . . . . . . . . . . . . . x . . . . . . . . . . . . . . . . . . . . . . .
		. . . . . . . . . . . . . . . . x . . . . . . . . . . . . . . . . . . . . . . .
		. . . . . . . . . . . . . . . . x . . . . . . . . . . . . . . . . . . . . . . .
		. . . . . . . . . . . . . . . . x . . . . . . . . . . . . . . . . . . . . . . .
		. . . . . . . . . . x x x x x x x . . . . . . . . . . . . . . . . . . . . . . .
	</shadow-mask>
	<shadow-mask>
		. . . . . . . . . . . . . . . . . . . . . . . . . . . . . . . . . . . . . . . .
		. . . . . . . . . . . . . . . . . . . . . . . . . . . . . . . . . . . . . . . .
		. . . . . . . . . . . . . . . . . . . . . . . . . . . . . . . . . . . . . . . .
		. . . . . . . . . . . . . . . . . . . . . . . . . . . . . . . . . . . . . . . .
		. . . . . . . . . . . . . . . . . . . . . . . . . . . . . . . . . . . . . . . .
		. . . . . . . . . . . . . . . . . . . . . . . . . . . . . . . . . . . . . . . .
		. . . . . . . . . . . . . . . . . . . . . . . . . . . . . . . . . . . . . . . .
		. . . . . . . . . . . . . . . . . . . . . . . . . . . . . . . . . . . . . . . .
		. . . . . . . . . . . . . . . . . . . . . . . . . . . . . . . . . . . . . . . .
		. . . . . . . . . . . . . . . . . . . . . . . . . . . . . . . . . . . . . . . .
		. . . . . . . . . . . . . . . . . . . . . . . . . . . . . . . . . . o . . . . .
		. . . . . . . . . . . . . . . . . . . . . . . . . . . . . . . . . . o . . x x x
		. . . . . . . . . . . . . . . . . . . . . . . . . . . . . . . . . . o . . . . .
		. . . . . . . . . . . . . . . . . . . . . . . . . . . . . . . . . . . . . . . .
		. . . . . . . . . . . . . . . . . . . . . . . . . . . . . . . . . . . . . . . .
		. . . . . . . . . . . . . . . . . . . . . . . . . . . . . . . . . . . . . . . .
		. . . . . . . . . . . . . . . . . . . . . . . . . . . . . . . . . . . . . . . .
		. . . . . . . . . . . . . . . . . . . . . . . . . . . . . . . . . . . . . . . .
		. . . . . . . . . . . . . . . . . . . . . . . . . . . . . . . . . . . . . . . .
		. . . . . . . . . . . . . . . . . . . . . . . . . . . . . . . . . . . . . . . .
		. . . . . . . . . . . . . . . . . . . . . . . . . . . . . . . . . . . . . . . .
		. . . . . . . . . . . . . . . . . . . . . . . . . . . . . . . . . . . . . . . .
		. . . . . . . . . . . . . . . . . . . . . . . . . . . . . . . . . . . . . . . .
	</shadow-mask>
	<shadow-mask>
		. . . . . . . . . . . . . . . . . . . . . . . . . . . . . . . . . . . . . . . .
		. . . . . . . . . . . . . . . . . . . . . . . . . . . . . . . . . . . . . . . .
		. . . . . . . . . . . . . . . . . . . . . . . . . . . . . . . . . . . . . . . .
		. . . . . . . . . . . . . . . . . . . . . . . . . . . . . . . . . . . . . . . .
		. . . . . . . . . . . . . . . . . . . . . . . . . . . . . . . . . . . . . . . .
		. . . . . . . . . . . . . . . . . . . . . . . . . . . . . . . . . . . . . . . .
		. . . . . . . . . . . . . . . . . . . . . . . . . . . . . . . . . . . . . . . .
		. . . . . . . . . . . . . . . . . . . . . . . . . . . . . . . . . . . . . . . .
		. . . . . . . . . . . . . . . . . . . . . . . . . . . . . . . . . . . . . . . .
		. . . . . . . . . . . . . . . . . . . . . . . . . . . . . . . . . . . . . . . .
		. . . . . . . . . . . . . . . . . . . . . . . . . . . . . . . . . . . . . . . .
		. . . . . . . . . . . . . . . . . . . . . . . . . x x x o . . . . . . . . . . .
		. . . . . . . . . . . . . . . . . . . . . . . . . . x . . x . . . . . . . . . .
		. . . . . . . . . . . . . . . . . . . . . . . . . . x . . x . . . . . . . . . .
		. . . . . . . . . . . . . . . . . . . . . . . . . . x . . x . . . . . . . . . .
		. . . . . . . . . . . . . . . . . . . . . . . . . x x x x x . . . . . . . . . .
		. . . . . . . . . . . . . . . . . . . . . . . . . . . . . . . . . . . . . . . .
		. . . . . . . . . . . . . . . . . . . . . . . . . . . . . . . . . . . . . . . .
		. . . . . . . . . . . . . . . . . . . . . . . . . . . . . . . . . . . . . . . .
		. . . . . . . . . . . . . . . . . . . . . . . . . . . . . . . . . . . . . . . .
		. . . . . . . . . . . . . . . . . . . . . . . . . . . . . . . . . . . . . . . .
		. . . . . . . . . . . . . . . . . . . . . . . . . . . . . . . . . . . . . . . .
		. . . . . . . . . . . . . . . . . . . . . . . . . . . . . . . . . . . . . . . .
	</shadow-mask>
	<shadow-mask>
		. . . . . . . . . . . . . . . . . . . . . . . . . . . . . . . . . . . . . . . .
		. . . . . . . . . . . . . . . . . . . . . . . . . . . . . . . . . . . . . . . .
		. . . . . . . . . . . . . . . . . . . . . . . . . . . . . . . . . . . . . . . .
		. . . . . . . . . . . . . . . . . . . . . . . . . . . . . . . . . . . . . . . .
		. . . . . . . . . . . . . . . . . . . . . . . . . . . . . . . . . . . . . . . .
		. . . . . . . . . . . . . . . . . . . . . . . . . . . . . . . . . . . . . . . .
		. . . . . . . . . . . . . . . . . . . . . . . . . . . . . . . . . . . . . . . .
		. . . . . . . . . . . . . . . . . . . . . . . . . . . . . . . . . . . . . . . .
		. . . . . . . . . . . . . . . . . . . . . . . . . . . . . . . . . . . . . . . .
		. . . . . . . . . . . . . . . . . . . . . . . x . . . . . . . . . . . . . . . .
		. . . . . . . . . . . . . . . . . . . . . . . x . . . . . . . . . . . . . . . .
		. . . . . . . . . . . . . . . . . . . . . . o . . . . . . . . . . . . . . . . .
		. . . . . . . . . . . . . . . . . . . . . . . x . . . . . . . . . . . . . . . .
		. . . . . . . . . . . . . . . . . . . . . . . x . . . . . . . . . . . . . . . .
		. . . . . . . . . . . . . . . . . . . . . . . . . . . . . . . . . . . . . . . .
		. . . . . . . . . . . . . . . . . . . . . . . . . . . . . . . . . . . . . . . .
		. . . . . . . . . . . . . . . . . . . . . . . . . . . . . . . . . . . . . . . .
		. . . . . . . . . . . . . . . . . . . . . . . . . . . . . . . . . . . . . . . .
		. . . . . . . . . . . . . . . . . . . . . . . . . . . . . . . . . . . . . . . .
		. . . . . . . . . . . . . . . . . . . . . . . . . . . . . . . . . . . . . . . .
		. . . . . . . . . . . . . . . . . . . . . . . . . . . . . . . . . . . . . . . .
		. . . . . . . . . . . . . . . . . . . . . . . . . . . . . . . . . . . . . . . .
		. . . . . . . . . . . . . . . . . . . . . . . . . . . . . . . . . . . . . . . .
	</shadow-mask>
</level>