<level name="The control room...">
	<map>
		. . . . . . . . . . . . . . . . . . . . . o o o o o o o o . . . . . . . . .
		. . . . . . . . . . . . . . . . . . . . . o . . . o o o o o o * . . . . . .
		. . . . . . . . . . . . . . . . . . . . . o . . . o o o o . . . . . . . . .
		. . . . . . . . . . . . . . . . . . . o . o . . . . . . . . . . . . . . . .
		. w w w w w w w w w w w w w w w o b o o o o . . . . . . . . . . . . . . . .
		. . w . . . . . . . w . . . . . . o o o o o . . . . . . l . . . . . . . . .
		. . w w w w w w w w w . . . . . o o o @ o o o . . . . . l . . . . . . . . .
		. . . . . . . . . . . . . . . . . o o o o o . . . . . . l . . . . . . . . .
		. . . . . . . . . . . . . . . . . o o o o r o l l l l l l l l l . . . . . .
		. . . . . . . . . . . . . . . . . . . o T . . . . . . . l . l l l . . . . .
		. . . . . . . . . . . . . . . . . . . o . . . . . . . . l . l l l . . . . .
		. . . . . . . . . . . . . . . . . . . o . . . . . . . l l . l l . . . . . .
		. . . . . . . . . * o o o o o o o o o o . . . . . . . l l l l l . . . . . .
	</map>
	<shadow-mask>
		. . . . . . . . . . . . . . . . . . . . . x x x x x x x x . . . . . . . . .
		. . . . . . . . . . . . . . . . . . . . . x . . . x x x x x x x . . . . . .
		. . . . . . . . . . . . . . . . . . . . . x . . . x x x x . . . . . . . . .
		. . . . . . . . . . . . . . . . . . . . . x . . . . . . . . . . . . . . . .
		. . . . . . . . . . . . . . . . . . . . . . . . . . . . . . . . . . . . . .
		. . . . . . . . . . . . . . . . . . . . . . . . . . . . . . . . . . . . . .
		. . . . . . . . . . . . . . . . . . . . . . . . . . . . . . . . . . . . . .
		. . . . . . . . . . . . . . . . . . . . . . . . . . . . . . . . . . . . . .
		. . . . . . . . . . . . . . . . . . . . . . . . . . . . . . . . . . . . . .
		. . . . . . . . . . . . . . . . . . . . . . . . . . . . . . . . . . . . . .
		. . . . . . . . . . . . . . . . . . . . . . . . . . . . . . . . . . . . . .
		. . . . . . . . . . . . . . . . . . . . . . . . . . . . . . . . . . . . . .
		. . . . . . . . . . . . . . . . . . . . . . . . . . . . . o . . . . . . . .
	</shadow-mask>
	<shadow-mask>
		. . . . . . . . . . . . . . . . . . . . . . . . . . . . . . . . . . . . . .
		. . . . . . . . . . . . . . . . . . . . . . . . . . . . . . . . . . . . . .
		. . . . . . . . . . . . . . . . . . . . . . . . . o . . . . . . . . . . . .
		. . . . . . . . . . . . . . . . . . . . . . . . . . . . . . . . . . . . . .
		. x x x x x x . . . . . . . . . . . . . . . . . . . . . . . . . . . . . . .
		. . x . . . . . . . x . . . . . . . . . . . . . . . . . . . . . . . . . . .
		. . x x x x x x x x x . . . . . . . . . . . . . . . . . . . . . . . . . . .
		. . . . . . . . . . . . . . . . . . . . . . . . . . . . . . . . . . . . . .
		. . . . . . . . . . . . . . . . . . . . . . . . . . . . . . . . . . . . . .
		. . . . . . . . . . . . . . . . . . . . . . . . . . . . . . . . . . . . . .
		. . . . . . . . . . . . . . . . . . . . . . . . . . . . . . . . . . . . . .
		. . . . . . . . . . . . . . . . . . . . . . . . . . . . . . . . . . . . . .
		. . . . . . . . . . . . . . . . . . . . . . . . . . . . . . . . . . . . . .
	</shadow-mask>
	<shadow-mask>
		. . . . . . . . . . . . . . . . . . . . . . . . . . . . . . . . . . . . . .
		. . . . . . . . . . . . . . . . . . . . . . . . . . . . . . . . . . . . . .
		. . . . . . . . . . . . . . . . . . . . . . . . . . . . . . . . . . . . . .
		. . . . . . . . . . . . . . . . . . . . . . . . . . . . . . . . . . . . . .
		. o . . . . . . . . . . . . . . . . . . . . . . . . . . . . . . . . . . . .
		. . . . . . . . . . . . . . . . . . . . . . . . . . . . x . . . . . . . . .
		. . . . . . . . . . . . . . . . . . . . . . . . . . . . x . . . . . . . . .
		. . . . . . . . . . . . . . . . . . . . . . . . . . . . x . . . . . . . . .
		. . . . . . . . . . . . . . . . . . . . . . . . . . . . . . . . . . . . . .
		. . . . . . . . . . . . . . . . . . . . . . . . . . . . x . . . . . . . . .
		. . . . . . . . . . . . . . . . . . . . . . . . . . . . x . . . . . . . . .
		. . . . . . . . . . . . . . . . . . . . . . . . . . . x x . . . . . . . . .
		. . . . . . . . . . . . . . . . . . . . . . . . . . . x x . . . . . . . . .
	</shadow-mask>
	<shadow-mask>
		. . . . . . . . . . . . . . . . . . . . . . . . . . . . . . . . . . . . . .
		. . . . . . . . . . . . . . . . . . . . . . . . . . . . . . . . . . . . . .
		. . . . . . . . . . . . . . . . . . . . . . . . . . . . . . . . . . . . . .
		. . . . . . . . . . . . . . . . . . . . . . . . . . . . . . . . . . . . . .
		. . . . . . . . . . . . . . . . . . . . . . . . . . . . . . . . . . . . . .
		. . . . . . . . . . . . . . . . . . . . . . . . . . . . o . . . . . . . . .
		. . . . . . . . . . . . . . . . . . . . . . . . . . . . . . . . . . . . . .
		. . . . . . . . . . . . . . . . . . . . . . . . . . . . . . . . . . . . . .
		. . . . . . . . . . . . . . . . . . . . . . . . . . . . . . . . . . . . . .
		. . . . . . . . . . . . . . . . . . . . . . . . . . . . . . . . . . . . . .
		. . . . . . . . . . . . . . . . . . . x . . . . . . . . . . . . . . . . . .
		. . . . . . . . . . . . . . . . . . . x . . . . . . . . . . . . . . . . . .
		. . . . . . . . . x x x x x x x x x x x . . . . . . . . . . . . . . . . . .
	</shadow-mask>
	<shadow-mask>
		. . . . . . . . . . . . . . . . . . . . . . . . . . . . . . . . . . . . . .
		. . . . . . . . . . . . . . . . . . . . . . . . . . . . . . . . . . . . . .
		. . . . . . . . . . . . . . . . . . . . . . . . . . . . . . . . . . . . . .
		. . . . . . . . . . . . . . . . . . . . . . . . . . . . . . . . . . . . . .
		. . . . . . . . . . o . . . . . . . . . . . . . . . . . . . . . . . . . . .
		. . . . . . . . . . . . . . . . . . . . . . . . . . . . . . . . . . . . . .
		. . . . . . . . . . . . . . . . o . . . . . . . . . . . . . . . . . . . . .
		. . . . . . . . . . . . . . . . . . . . . . . . . . . . . . . . . . . . . .
		. . . . . . . . . . . . . . . . . . . . . . . . . . . . . . . . . . . . . .
		. . . . . . . . . . . . . . . . . . . . . . . . . . . . . . . . . . . . . .
		. . . . . . . . . . . . . . . . . . . . . . . . . . . . . . x x x . . . . .
		. . . . . . . . . . . . . . . . . . . . . . . . . . . . . . x x . . . . . .
		. . . . . . . . . . . . . . . . . . . . . . . . . . . . . . x x . . . . . .
	</shadow-mask>
	<shadow-mask>
		. . . . . . . . . . . . . . . . . . . . . . . . . . . . . . . . . . . . . .
		. . . . . . . . . . . . . . . . . . . . . . . . . . . . . . . . . . . . . .
		. . . . . . . . . . . . . . . . . . . . . . . . . . . . . . . . . . . . . .
		. . . . . . . . . . . . . . . . . . . o . . . . . . . . . . . . . . . . . .
		. . . . . . . . x x . x x . . . . . . . . . . . . . . . . . . . . . . . . .
		. . . . . . . . . . . . . . . . . . . . . . . . . . . . . . . . . . . . . .
		. . . . . . . . . . . . . . . . . . . . . . . . . . . . . . . . . . . . . .
		. . . . . . . . . . . . . . . . . . . . . . . . . . . . . . . . . . . . . .
		. . . . . . . . . . . . . . . . . . . . . . . . . . . . o . . . . . . . . .
		. . . . . . . . . . . . . . . . . . . . . . . . . . . . . . . . . . . . . .
		. . . . . . . . . . . . . . . . . . . . . . . . . . . . . . . . . . . . . .
		. . . . . . . . . . . . . . . . . . . . . . . . . . . . . . . . . . . . . .
		. . . . . . . . . . . . . . . . . . . . . . . . . . . . . . . . . . . . . .
	</shadow-mask>
	<shadow-mask>
		. . . . . . . . . . . . . . . . . . . . . . . . . . . . . . . . . . . . . .
		. . . . . . . . . . . . . . . . . . . . . . . . . . . . . . . . . . . . . .
		. . . . . . . . . . . . . . . . . . . . . . . . . . . . . . . . . . . . . .
		. . . . . . . . . . . . . . . . . . . . . . . . . . . . . . . . . . . . . .
		. . . . . . . . . . . . . . . . . . . . . . . . . . . . . . . . . . . . . .
		. . . . . . . . . . . . . . . . . . . . . . . . . . . . . . . . . . . . . .
		. . . . . . . . . . . . . . . . . . . . . . o . . . . . . . . . . . . . . .
		. . . . . . . . . . . . . . . . . . . . . . . . . . . . . . . . . . . . . .
		. . . . . . . . . . . . . . . . . . . . . . . . . . x x . x x . . . . . . .
		. . . . . . . . . . . . . . . . . . . . . . . . . . . . . . . . . . . . . .
		. . . . . . . . . . . . . . . . . . . . . . . . . . . . . . . . . . . . . .
		. . . . . . . . . . . . . . . . . . . . . . . . . . . . . . . . . . . . . .
		. . . . . . . . . . . . . . . . . . . . . . . . . . . . . . . . . . . . . .
	</shadow-mask>
</level>