<level name="So it begins">
	<map>
		. . . . . o o o . . .
		@ o o o o o . o o b o
		. . . . . o o o o o o
		. . . o o o . . w . .
		. . . o o o . . w . .
		. . . * o o . . w . .
		. . . . . . . . * . .
	</map>
	<shadow-mask>
		. . . . . . . . . . .
		. . . . . . . . . . .
		. . . . . . . . . . o
		. . . x x . . . x . .
		. . . x x x . . x . .
		. . . x x x . . x . .
		. . . . . . . . . . .
	</shadow-mask>
</level>