<level name="Through darkness...">
	<map>
		l l l l l l l l l
		. l l l l l l l .
		. o o l l l o r .
		. o o o l o o o .
		. o o o @ r o o .
		. o o o o o o o .
		. o o o o o o * .
		. * o o o * o o .
		. o o o * * o o .
		. o o o o o o o .
		. . . . o T . . .
		. . . . * . . . .
	</map>
	<shadow-mask>
		. . . . . . . . .
		. . . . . . . . .
		. x x . . . . . .
		. x x x . . . . .
		. x x x . . . . .
		. x x x x x . . .
		. . . . . . . . .
		. . x x x . . . .
		. . . . . . . . .
		. x x x . x x x .
		. . . . . . . . .
		. . . . . . . . .
	</shadow-mask>
	<shadow-mask>
		. . . . o . . . .
		. . . . . . . . .
		. . . . . . . . .
		. . . . . . . . .
		. . . . . . . . .
		. . . . . . . . .
		. . . . . . . . .
		. . . . . . . . .
		. . . . . . . . .
		. . . . x . . . .
		. . . . x . . . .
		. . . . x . . . .
	</shadow-mask>
	<shadow-mask>
		. . . o . . . . .
		. . . . . . . . .
		. . . . . . . . .
		. . . . . . . . .
		. . . . . . . . .
		. . . . . . . . .
		. . . . . . . . .
		. . . . . . . . .
		. x x x x . . . .
		. . . . . . . . .
		. . . . . . . . .
		. . . . . . . . .
	</shadow-mask>
	<shadow-mask>
		. o . . . . . . .
		. . . . . . . . .
		. . . . . . . . .
		. . . . . . . . .
		. . . . . . . . .
		. . . . . . . . .
		. x x x x x . . .
		. x . . . . . . .
		. . . . . . . . .
		. . . . . . . . .
		. . . . . . . . .
		. . . . . . . . .
	</shadow-mask>
	<shadow-mask>
		. . . . . . o . .
		. . . . . . . . .
		. . . . . . . . .
		. . . . . . . . .
		. . . . . . . . .
		. . . . . . . . .
		. . . . . . x . .
		. . . . . x x . .
		. . . . . . . . .
		. . . . . . . . .
		. . . . . . . . .
		. . . . . . . . .
	</shadow-mask>
	<shadow-mask>
		. . . . . o . . .
		. . . . . . . . .
		. . . . . . . . .
		. . . . . . . . .
		. . . . . . x . .
		. . . . . . . . .
		. . . . . . . . .
		. . . . . . . x .
		. . . . . x x x .
		. . . . . . . . .
		. . . . . . . . .
		. . . . . . . . .
	</shadow-mask>
	<shadow-mask>
		. . o . . . . . .
		. . . . . . . . .
		. . . . . . . . .
		. . . . . . . x .
		. . . . . . . x .
		. . . . . . x x .
		. . . . . . . x .
		. . . . . . . . .
		. . . . . . . . .
		. . . . . . . . .
		. . . . . . . . .
		. . . . . . . . .
	</shadow-mask>
	<shadow-mask>
		. . . . . . . o .
		. . . . . . . . .
		. . . . . . x x .
		. . . . . x x . .
		. . . . . . . . .
		. . . . . . . . .
		. . . . . . . . .
		. . . . . . . . .
		. . . . . . . . .
		. . . . . . . . .
		. . . . . . . . .
		. . . . . . . . .
	</shadow-mask>
	<dialog trigger="5,7" blocksGameplay="false">
		<text wait="1">It's dark down here...\n</text>
		<text wait="3">\tBest turn back!</text>
	</dialog>
</level>